"filename", "language", "Markdown", "JSON", "JavaScript", "HTML", "CSS", "comment", "blank", "total"
"d:\BingYan_internship\README.md", "Markdown", 39, 0, 0, 0, 0, 0, 16, 55
"d:\BingYan_internship\api_server\app.js", "JavaScript", 0, 0, 39, 0, 0, 27, 20, 86
"d:\BingYan_internship\api_server\config.js", "JavaScript", 0, 0, 4, 0, 0, 2, 0, 6
"d:\BingYan_internship\api_server\db\index.js", "JavaScript", 0, 0, 8, 0, 0, 3, 5, 16
"d:\BingYan_internship\api_server\package-lock.json", "JSON", 0, 3722, 0, 0, 0, 0, 1, 3723
"d:\BingYan_internship\api_server\package.json", "JSON", 0, 25, 0, 0, 0, 0, 1, 26
"d:\BingYan_internship\api_server\router\artcate.js", "JavaScript", 0, 0, 12, 0, 0, 9, 4, 25
"d:\BingYan_internship\api_server\router\article.js", "JavaScript", 0, 0, 10, 0, 0, 7, 8, 25
"d:\BingYan_internship\api_server\router\user.js", "JavaScript", 0, 0, 8, 0, 0, 8, 4, 20
"d:\BingYan_internship\api_server\router\userinfo.js", "JavaScript", 0, 0, 5, 0, 0, 2, 3, 10
"d:\BingYan_internship\api_server\router_handler\artcate.js", "JavaScript", 0, 0, 48, 0, 0, 24, 20, 92
"d:\BingYan_internship\api_server\router_handler\article.js", "JavaScript", 0, 0, 13, 0, 0, 13, 4, 30
"d:\BingYan_internship\api_server\router_handler\user.js", "JavaScript", 0, 0, 40, 0, 0, 39, 15, 94
"d:\BingYan_internship\api_server\router_handler\userinfo.js", "JavaScript", 0, 0, 13, 0, 0, 6, 6, 25
"d:\BingYan_internship\api_server\schema\artcate.js", "JavaScript", 0, 0, 20, 0, 0, 6, 6, 32
"d:\BingYan_internship\api_server\schema\article.js", "JavaScript", 0, 0, 12, 0, 0, 3, 3, 18
"d:\BingYan_internship\api_server\schema\user.js", "JavaScript", 0, 0, 9, 0, 0, 13, 4, 26
"d:\BingYan_internship\dig-gold\CSS\art_pub.css", "CSS", 0, 0, 0, 0, 76, 3, 10, 89
"d:\BingYan_internship\dig-gold\CSS\attention.css", "CSS", 0, 0, 0, 0, 147, 127, 17, 291
"d:\BingYan_internship\dig-gold\CSS\boiling.css", "CSS", 0, 0, 0, 0, 236, 4, 10, 250
"d:\BingYan_internship\dig-gold\CSS\common.css", "CSS", 0, 0, 0, 0, 267, 8, 37, 312
"d:\BingYan_internship\dig-gold\CSS\fa\css\all.css", "CSS", 0, 0, 0, 0, 4786, 7, 2211, 7004
"d:\BingYan_internship\dig-gold\CSS\fa\css\all.min.css", "CSS", 0, 0, 0, 0, 1, 5, 0, 6
"d:\BingYan_internship\dig-gold\CSS\fa\css\brands.css", "CSS", 0, 0, 0, 0, 948, 5, 471, 1424
"d:\BingYan_internship\dig-gold\CSS\fa\css\brands.min.css", "CSS", 0, 0, 0, 0, 1, 5, 0, 6
"d:\BingYan_internship\dig-gold\CSS\fa\css\fontawesome.css", "CSS", 0, 0, 0, 0, 3781, 7, 1732, 5520
"d:\BingYan_internship\dig-gold\CSS\fa\css\fontawesome.min.css", "CSS", 0, 0, 0, 0, 1, 5, 0, 6
"d:\BingYan_internship\dig-gold\CSS\fa\css\regular.css", "CSS", 0, 0, 0, 0, 12, 5, 3, 20
"d:\BingYan_internship\dig-gold\CSS\fa\css\regular.min.css", "CSS", 0, 0, 0, 0, 1, 5, 0, 6
"d:\BingYan_internship\dig-gold\CSS\fa\css\solid.css", "CSS", 0, 0, 0, 0, 12, 5, 3, 20
"d:\BingYan_internship\dig-gold\CSS\fa\css\solid.min.css", "CSS", 0, 0, 0, 0, 1, 5, 0, 6
"d:\BingYan_internship\dig-gold\CSS\fa\css\svg-with-js.css", "CSS", 0, 0, 0, 0, 552, 5, 78, 635
"d:\BingYan_internship\dig-gold\CSS\fa\css\svg-with-js.min.css", "CSS", 0, 0, 0, 0, 1, 5, 0, 6
"d:\BingYan_internship\dig-gold\CSS\fa\css\v4-font-face.css", "CSS", 0, 0, 0, 0, 18, 5, 4, 27
"d:\BingYan_internship\dig-gold\CSS\fa\css\v4-font-face.min.css", "CSS", 0, 0, 0, 0, 1, 5, 0, 6
"d:\BingYan_internship\dig-gold\CSS\fa\css\v4-shims.css", "CSS", 0, 0, 0, 0, 1534, 5, 608, 2147
"d:\BingYan_internship\dig-gold\CSS\fa\css\v4-shims.min.css", "CSS", 0, 0, 0, 0, 1, 5, 0, 6
"d:\BingYan_internship\dig-gold\CSS\fa\css\v5-font-face.css", "CSS", 0, 0, 0, 0, 15, 5, 3, 23
"d:\BingYan_internship\dig-gold\CSS\fa\css\v5-font-face.min.css", "CSS", 0, 0, 0, 0, 1, 5, 0, 6
"d:\BingYan_internship\dig-gold\CSS\home.css", "CSS", 0, 0, 0, 0, 284, 7, 8, 299
"d:\BingYan_internship\dig-gold\CSS\index-hotlist.css", "CSS", 0, 0, 0, 0, 268, 9, 31, 308
"d:\BingYan_internship\dig-gold\CSS\index.css", "CSS", 0, 0, 0, 0, 455, 10, 29, 494
"d:\BingYan_internship\dig-gold\CSS\login.css", "CSS", 0, 0, 0, 0, 67, 1, 10, 78
"d:\BingYan_internship\dig-gold\CSS\minirefresh.css", "CSS", 0, 0, 0, 0, 220, 24, 1, 245
"d:\BingYan_internship\dig-gold\CSS\register.css", "CSS", 0, 0, 0, 0, 56, 1, 7, 64
"d:\BingYan_internship\dig-gold\CSS\reset.css", "CSS", 0, 0, 0, 0, 186, 2, 23, 211
"d:\BingYan_internship\dig-gold\CSS\searcharticle.css", "CSS", 0, 0, 0, 0, 0, 0, 1, 1
"d:\BingYan_internship\dig-gold\CSS\userinfo.css", "CSS", 0, 0, 0, 0, 59, 1, 8, 68
"d:\BingYan_internship\dig-gold\art_pub.html", "HTML", 0, 0, 0, 62, 0, 7, 1, 70
"d:\BingYan_internship\dig-gold\article1.html", "HTML", 0, 0, 0, 18, 0, 0, 2, 20
"d:\BingYan_internship\dig-gold\boiling.html", "HTML", 0, 0, 0, 255, 0, 1, 13, 269
"d:\BingYan_internship\dig-gold\headline.html", "HTML", 0, 0, 0, 159, 0, 4, 17, 180
"d:\BingYan_internship\dig-gold\home.html", "HTML", 0, 0, 0, 122, 0, 6, 6, 134
"d:\BingYan_internship\dig-gold\index-hotlist.html", "HTML", 0, 0, 0, 202, 0, 6, 10, 218
"d:\BingYan_internship\dig-gold\index.html", "HTML", 0, 0, 0, 381, 0, 6, 6, 393
"d:\BingYan_internship\dig-gold\js\ajax.js", "JavaScript", 0, 0, 49, 0, 0, 25, 1, 75
"d:\BingYan_internship\dig-gold\js\common.js", "JavaScript", 0, 0, 62, 0, 0, 31, 23, 116
"d:\BingYan_internship\dig-gold\js\front.js", "JavaScript", 0, 0, 10, 0, 0, 1, 4, 15
"d:\BingYan_internship\dig-gold\js\minirefresh.js", "JavaScript", 0, 0, 957, 0, 0, 289, 226, 1472
"d:\BingYan_internship\dig-gold\login.html", "HTML", 0, 0, 0, 45, 0, 30, 7, 82
"d:\BingYan_internship\dig-gold\register.html", "HTML", 0, 0, 0, 41, 0, 0, 4, 45
"d:\BingYan_internship\dig-gold\sercharticle.html", "HTML", 0, 0, 0, 66, 0, 0, 14, 80
"d:\BingYan_internship\dig-gold\userinfo.html", "HTML", 0, 0, 0, 41, 0, 2, 10, 53
"d:\BingYan_internship\logs.md", "Markdown", 97, 0, 0, 0, 0, 0, 64, 161
"d:\BingYan_internship\package-lock.json", "JSON", 0, 24, 0, 0, 0, 0, 1, 25
"d:\BingYan_internship\package.json", "JSON", 0, 5, 0, 0, 0, 0, 1, 6
"d:\BingYan_internship\实习总结报告.md", "Markdown", 28, 0, 0, 0, 0, 0, 20, 48
"d:\BingYan_internship\服务器端口汇总.md", "Markdown", 12, 0, 0, 0, 0, 0, 4, 16
"Total", "-", 176, 3776, 1319, 1392, 13988, 861, 5859, 27371